NO ./textures/laine4k.xpm
 SO ./textures/gold.xpm
    WE ./textures/moutain.xpm
 EA ./textures/grenouille.xpm

F 204,255,255
C   255,204,153

        
    
           

11111111111                                       11111111111
10101000001                                       10100000101
1010101110111111111111111111111111111111111111111110111110101
1000001010001000100010001000000S10000000100000101010000010101
1010111010101011101011101011111011111011111010101011111010101
1010001000100000101000100000100000000010100010100000101000001
1111111110111110101011101110111010111110101110101110101011101
1010000000000000001000001000001010000000000010000010000010001
1011111110111111111111111111111011111111111111111110111011101
10000000001                 1000001               10100010001
11111111111                 1011111               11111111111
                            1010101
                            1010101
                            1000101
                            1010101
                            1010001
                            1011111
                            1000001
                            1111101
                            1010001
                            1010111
                            1000001
                            1110101
                            1010101
                            1010101
                            1000101
                            1011101
                            1010001
                            1011111
                            1000001
                            1010101
                            1010101
                            1110111
                            1000001
                            1011101
                            1010001
                            1010101
                            1010101
                            1011111
                            1000001
                            1111101
                            1000001
                            1110111
                            1010001
                            1011101
                            1000001
                            1011101
                            1010001
                     111111110111011111111
                     100010000010001000001
                     101110101011101011111
                     101010101010100000001
                     101011101010101111101
                     100000101000100010001
                     101111101110101111101
                     100000000010000010001
                     111111101011111111111
                     101000001000001000001
                     101011111011101111101
                     101010101010000010001
                     101010101110111111101
                     100000000010101010001
                     101011101111101011101
                     101010001000000000101
                     101010111110101111101
                     101010100000100000001
                     111110111110101110111
                     100000000000101000001
                     111111111111111111111





             
                

