NO ./path_to_the_north_texture			
 SO ./path_to_the_south_texture
    WE ./path_to_the_west_texture		
 EA ./path_to_the_east_texture    
F              225,100,69				
C          225    ,30  ,    84   

         11111111111111111111111
        1000000000110000000000001
        1011000001110000000000001
        1001000000000000000000001
 11111111011000001110000000000001
10000000001100000111011111111111
11110111111111011100000010001
1111111111111011101010010001
1100000110101011100000010001
10000000000000001100000010001             1
1E000000000000001101010010001            101111111111111111111111111111111111111111111111111111
11110001111111111111111111111             1
11100111 1110101 101111010001
 1111111 1111111 11111111111
