NO ./textures/grenouille.xpm	
 SO ./textures/mariowall.xpm	
    WE ./textures/carrelage.xpm			
 EA ./textures/sang.xpm	   
F	204,255,255   
C   255,204,153				

         11111111111111111111111
        1000000000110000000000001
        1011000001110000000000001
        1001000000000000000000001
 11111111011000001110000000000001
10000000001100000111011111111111
11110111111111011100000010001
11111111111111011101010010001
11000000010101011100000010001
10000000000000001100000010001             1
100000000000000011010N0010001            101111111111111111111111111111111111111111111111111111
11110001111111111111111111111             1
11100011 1110101 101111010001
 1111111 1111111 11111111111
