NO ./path_to_the_north_texture			
 SO ./path_to_the_south_texture
    WE ./path_to_the_west_texture		
 EA ./path_to_the_east_texture    
F              225,100,69				
C          225    ,30  ,    84   

111111111111
100000000001
100000N00001
100000100001
111111111111
