NO ./sprites/basic.xpm
SO ./sprites/basic.xpm
WE ./sprites/basic.xpm
EA ./sprites/basic.xpm

C 26,161,199
F 107,75,85


11111111111
10000000001
10000000001
10000000001
10000000001
10000000001W
10000000001
10000000001
10000000001
10000000001
11111111111
